<         >
<         >
<         >
<         >
<         >
<    S    >
<         >
<         >
<         >
<         >
<         >
<         >
O===3 C===O
<  >< ><X >
<E >< ><FF>
<  >< ><FF>
<  >< ><FF>
<     ><FF>
<         >
<         >
<         >
<         >
<         >
O_________O
