<         >
<         >
<         >
<         >
<         >
<         >
<         >
<FFFF  FFF>
<FFFF  FFF>
<         >
 ======3  >
<         >
<    X    >
<         >
