<         >
<         >
<         >
<         >
<         >
<    S    >
<         >
<         >
<   F  FF >
<   F  FF >
<   F   F >
 ======3  >
<         >
<    X    >
<         >
