<         >
<         >
<         >
<         >
<         >
<        S>
O======3  >
<      |  >
<   |  |  >
<   |  |  >
<   |  |  >
<   |     >
<  C======O
<     B   >
O=====3   >
<        X>
O_________O
