<         >
<         >
<         >
<         >
<         >
<         >
<         >
<FFFF FFFF>
<FFFF FFFF>
<         >
 ======3  >
<         >
<         >
<         >
<   C===3 >
<F        >
<F        >
