<         >
<         >
<         >
<    F    >
<   F F   >
<  F S F  >
<   F F   >
<    F    >
<         >
<         >
O====3    >
<         >
<  X      >
O_________O
