<         >
<         >
<  S      >
<         >
<         >
<         >
<         >
<         >
<         >
<         >
<         >
<         >
<         >
<F   F    >
< F   F   >
<  F   F  >
<   F   F >
<    F   F>
<    F B F>
<    F   F>
<   F   F >
<  F   F  >
< F   F   >
<F        >
<     X   >
<         >
<         >
<         >
O_________O
